//MAP CONVERTED BY dmm2tgm.py THIS HEADER COMMENT PREVENTS RECONVERSION, DO NOT REMOVE
"a" = (
/turf/open/space/basic,
/area/space)
"f" = (
/obj/structure/table/wood,
/turf/open/floor/carpet,
/area/space)
"g" = (
/obj/machinery/computer/helm{
	dir = 8
	},
/obj/structure/table/reinforced,
/turf/open/floor/plasteel/patterned,
/area/space)
"i" = (
/obj/structure/cable{
	icon_state = "1-4"
	},
/obj/machinery/power/shuttle/engine/fueled/plasma{
	dir = 4
	},
/turf/open/floor/plating,
/area/space)
"j" = (
/obj/machinery/computer/crew,
/turf/open/floor/carpet,
/area/space)
"k" = (
/obj/machinery/power/port_gen/pacman/uranium,
/obj/structure/cable{
	icon_state = "0-2"
	},
/obj/structure/window/plasma/reinforced{
	dir = 1
	},
/obj/machinery/power/terminal,
/turf/open/floor/plating,
/area/space)
"m" = (
/obj/structure/cable{
	icon_state = "1-8"
	},
/obj/machinery/atmospherics/components/unary/shuttle/heater{
	dir = 4
	},
/obj/structure/window/plasma/reinforced{
	dir = 8
	},
/turf/open/floor/plating,
/area/space)
"n" = (
/obj/machinery/atmospherics/pipe/manifold/orange/visible{
	dir = 4
	},
/turf/open/floor/plating,
/area/space)
"o" = (
/obj/machinery/door/poddoor,
/turf/open/floor/plating,
/area/space)
"q" = (
/obj/machinery/power/shuttle/engine/fueled/plasma{
	dir = 4
	},
/turf/open/floor/plating,
/area/space)
"s" = (
/obj/machinery/power/apc/auto_name/east,
/obj/structure/cable,
/turf/open/floor/carpet,
/area/space)
"u" = (
/obj/structure/cable{
	icon_state = "4-8"
	},
/turf/open/floor/carpet,
/area/space)
"w" = (
/obj/machinery/power/smes/engineering,
/obj/structure/cable{
	icon_state = "0-2"
	},
/turf/open/floor/plating,
/area/space)
"x" = (
/obj/machinery/door/airlock/grunge,
/turf/open/floor/plasteel/patterned,
/area/space)
"y" = (
/turf/closed/wall/mineral/plastitanium/nodiagonal,
/area/space)
"z" = (
/obj/structure/chair/comfy/black{
	dir = 8
	},
/turf/open/floor/carpet,
/area/space)
"A" = (
/obj/structure/window/plasma/reinforced{
	dir = 1
	},
/obj/structure/table/reinforced,
/obj/item/storage/toolbox/syndicate,
/turf/open/floor/plating,
/area/space)
"C" = (
/obj/machinery/door/airlock/grunge,
/obj/structure/cable{
	icon_state = "4-8"
	},
/turf/open/floor/carpet,
/area/space)
"F" = (
/turf/open/floor/carpet,
/area/space)
"G" = (
/obj/structure/chair/comfy/shuttle{
	dir = 4
	},
/turf/open/floor/plasteel/patterned,
/area/space)
"I" = (
/turf/open/floor/plasteel/elevatorshaft,
/area/space)
"J" = (
/turf/open/floor/plating,
/area/space)
"K" = (
/obj/structure/window/plasma/reinforced/plastitanium,
/obj/structure/grille,
/turf/open/floor/plating,
/area/space)
"L" = (
/obj/machinery/door/airlock/grunge,
/turf/open/floor/plating,
/area/space)
"M" = (
/obj/structure/table/reinforced,
/obj/item/pipe_dispenser,
/turf/open/floor/plating,
/area/space)
"N" = (
/obj/machinery/atmospherics/pipe/simple/orange/visible{
	dir = 10
	},
/turf/open/floor/plating,
/area/space)
"Q" = (
/obj/structure/cable{
	icon_state = "1-2"
	},
/obj/structure/cable{
	icon_state = "1-4"
	},
/turf/open/floor/plating,
/area/space)
"S" = (
/obj/structure/window/plasma/reinforced,
/obj/structure/rack,
/obj/item/storage/bag/ore,
/obj/item/pickaxe/drill,
/obj/item/t_scanner/adv_mining_scanner/lesser,
/turf/open/floor/plating,
/area/space)
"U" = (
/obj/structure/stairs/east,
/turf/open/floor/plasteel/elevatorshaft,
/area/space)
"V" = (
/obj/structure/cable{
	icon_state = "2-8"
	},
/turf/open/floor/carpet,
/area/space)
"W" = (
/obj/machinery/atmospherics/components/unary/shuttle/heater{
	dir = 4
	},
/obj/structure/window/plasma/reinforced{
	dir = 8
	},
/turf/open/floor/plating,
/area/space)
"X" = (
/obj/machinery/power/apc/auto_name/east,
/obj/structure/cable,
/obj/machinery/atmospherics/components/binary/pump{
	dir = 1
	},
/turf/open/floor/plating,
/area/space)
"Y" = (
/obj/machinery/atmospherics/pipe/simple/orange/visible{
	dir = 9
	},
/turf/open/floor/plating,
/area/space)
"Z" = (
/obj/structure/window/plasma/reinforced,
/obj/structure/window/plasma/reinforced{
	dir = 1
	},
/obj/structure/window/plasma/reinforced{
	dir = 4
	},
/obj/structure/window/plasma/reinforced{
	dir = 8
	},
/obj/machinery/atmospherics/components/unary/passive_vent{
	dir = 1
	},
/turf/open/floor/plating,
/area/space)

(1,1,1) = {"
a
a
a
a
a
a
a
a
a
a
a
a
a
a
a
"}
(2,1,1) = {"
a
a
a
a
a
a
U
a
U
a
a
a
a
a
a
"}
(3,1,1) = {"
a
a
a
a
a
a
I
a
I
a
a
a
a
a
a
"}
(4,1,1) = {"
a
a
a
U
U
U
I
a
I
U
U
U
a
a
a
"}
(5,1,1) = {"
a
a
a
I
I
I
I
a
I
I
I
I
a
a
a
"}
(6,1,1) = {"
a
a
I
I
I
I
y
o
y
I
I
I
I
a
a
"}
(7,1,1) = {"
a
a
I
I
I
I
y
L
y
I
I
I
I
a
a
"}
(8,1,1) = {"
a
I
I
y
q
q
A
J
S
q
i
y
I
I
a
"}
(9,1,1) = {"
a
I
I
y
W
W
M
J
J
W
m
y
I
I
a
"}
(10,1,1) = {"
a
I
I
y
N
n
J
J
J
n
Y
y
I
I
a
"}
(11,1,1) = {"
a
I
I
y
y
k
w
Q
X
Z
y
y
I
I
a
"}
(12,1,1) = {"
a
a
I
I
y
y
y
C
y
y
y
I
I
a
a
"}
(13,1,1) = {"
a
a
a
I
I
y
j
u
f
y
I
I
a
a
a
"}
(14,1,1) = {"
a
a
a
I
I
y
F
u
z
y
I
I
a
a
a
"}
(15,1,1) = {"
a
a
a
I
I
y
F
V
s
y
I
I
a
a
a
"}
(16,1,1) = {"
a
a
a
a
I
y
y
x
y
y
I
a
a
a
a
"}
(17,1,1) = {"
a
a
a
a
I
I
K
G
K
I
I
a
a
a
a
"}
(18,1,1) = {"
a
a
a
a
I
I
K
g
K
I
I
a
a
a
a
"}
(19,1,1) = {"
a
a
a
a
a
I
K
K
K
I
a
a
a
a
a
"}
(20,1,1) = {"
a
a
a
a
a
I
I
K
I
I
a
a
a
a
a
"}
(21,1,1) = {"
a
a
a
a
a
a
I
I
I
a
a
a
a
a
a
"}
(22,1,1) = {"
a
a
a
a
a
a
I
I
I
a
a
a
a
a
a
"}
(23,1,1) = {"
a
a
a
a
a
a
a
I
a
a
a
a
a
a
a
"}
(24,1,1) = {"
a
a
a
a
a
a
a
a
a
a
a
a
a
a
a
"}
(25,1,1) = {"
a
a
a
a
a
a
a
a
a
a
a
a
a
a
a
"}
