//MAP CONVERTED BY dmm2tgm.py THIS HEADER COMMENT PREVENTS RECONVERSION, DO NOT REMOVE
"a" = (
/turf/open/space/basic,
/area/space)
"e" = (
/obj/machinery/disposal/bin,
/obj/structure/disposalpipe/trunk,
/turf/open/space/basic,
/area/space)
"f" = (
/obj/structure/catwalk,
/turf/closed/wall/mineral/titanium/nodiagonal,
/area/space)
"g" = (
/obj/structure/disposalpipe/segment{
	dir = 9
	},
/turf/open/space/basic,
/area/space)
"k" = (
/turf/closed/wall/mineral/titanium/nodiagonal,
/area/space)
"m" = (
/obj/structure/window/plasma/reinforced{
	dir = 1
	},
/obj/structure/window/plasma/reinforced{
	dir = 4
	},
/obj/machinery/igniter/incinerator_atmos,
/turf/open/space/basic,
/area/space)
"n" = (
/obj/structure/window/plasma/reinforced,
/obj/structure/window/plasma/reinforced{
	dir = 4
	},
/obj/structure/disposalpipe/trunk{
	dir = 4
	},
/obj/structure/disposaloutlet{
	dir = 1
	},
/turf/open/space/basic,
/area/space)
"u" = (
/obj/effect/spawner/structure/window/shuttle,
/obj/effect/spawner/structure/window/shuttle,
/turf/open/space/basic,
/area/space)
"v" = (
/obj/structure/window/plasma/reinforced,
/obj/structure/window/plasma/reinforced{
	dir = 8
	},
/turf/open/space/basic,
/area/space)
"w" = (
/obj/structure/window/plasma/reinforced{
	dir = 1
	},
/obj/structure/window/plasma/reinforced{
	dir = 4
	},
/turf/open/space/basic,
/area/space)
"A" = (
/obj/structure/window/plasma/reinforced,
/obj/structure/window/plasma/reinforced{
	dir = 8
	},
/obj/machinery/atmospherics/components/unary/vent_scrubber{
	dir = 8
	},
/turf/open/space/basic,
/area/space)
"C" = (
/obj/machinery/airalarm/directional/north,
/turf/open/space/basic,
/area/space)
"F" = (
/obj/structure/window/plasma/reinforced{
	dir = 1
	},
/obj/structure/window/plasma/reinforced{
	dir = 8
	},
/obj/machinery/atmospherics/components/unary/outlet_injector/on{
	dir = 8
	},
/turf/open/space/basic,
/area/space)
"H" = (
/obj/effect/spawner/structure/window/shuttle,
/turf/open/space/basic,
/area/space)
"I" = (
/obj/structure/catwalk,
/turf/open/space/basic,
/area/space)
"N" = (
/obj/structure/window/plasma/reinforced{
	dir = 1
	},
/obj/structure/window/plasma/reinforced{
	dir = 8
	},
/turf/open/space/basic,
/area/space)
"O" = (
/obj/machinery/airalarm/directional/east,
/turf/open/space/basic,
/area/space)
"T" = (
/obj/machinery/airalarm/directional/west,
/turf/open/space/basic,
/area/space)
"X" = (
/obj/structure/disposalpipe/segment,
/turf/open/space/basic,
/area/space)
"Z" = (
/obj/structure/window/plasma/reinforced,
/obj/structure/window/plasma/reinforced{
	dir = 4
	},
/turf/open/space/basic,
/area/space)

(1,1,1) = {"
a
a
a
a
a
a
a
a
a
a
a
a
a
a
a
a
a
a
a
a
"}
(2,1,1) = {"
a
a
a
a
a
a
a
a
a
a
a
a
a
a
a
a
a
a
a
a
"}
(3,1,1) = {"
a
k
a
a
k
I
I
k
k
a
a
k
k
I
I
k
a
a
k
a
"}
(4,1,1) = {"
a
k
a
a
k
a
a
k
a
a
a
a
k
a
a
k
a
a
k
a
"}
(5,1,1) = {"
a
k
a
a
k
I
I
k
C
a
a
a
k
I
I
k
a
a
k
a
"}
(6,1,1) = {"
a
a
k
k
a
a
a
k
a
a
a
a
k
a
a
a
k
k
a
a
"}
(7,1,1) = {"
a
a
a
a
a
k
H
k
a
k
k
a
k
H
k
a
a
a
a
a
"}
(8,1,1) = {"
a
a
a
k
k
a
a
a
a
a
a
a
a
a
a
f
f
a
a
a
"}
(9,1,1) = {"
a
a
k
N
v
a
a
a
a
a
a
a
a
a
a
N
v
k
a
a
"}
(10,1,1) = {"
a
a
k
w
Z
a
a
a
a
a
a
a
a
a
a
w
Z
k
a
a
"}
(11,1,1) = {"
a
k
a
a
a
a
a
a
a
a
a
a
a
a
a
a
a
a
k
a
"}
(12,1,1) = {"
a
k
a
a
a
a
a
a
a
a
a
a
a
a
a
a
a
a
k
a
"}
(13,1,1) = {"
a
k
a
a
a
a
a
a
a
a
a
O
a
a
a
a
a
a
k
a
"}
(14,1,1) = {"
a
a
k
a
a
a
a
a
k
F
A
k
a
a
a
a
a
k
a
a
"}
(15,1,1) = {"
a
a
k
a
a
a
a
a
k
m
n
k
a
a
a
a
a
k
a
a
"}
(16,1,1) = {"
a
a
a
k
k
a
a
a
e
X
g
a
a
a
a
k
k
a
a
a
"}
(17,1,1) = {"
a
a
a
a
k
a
a
a
a
a
a
a
a
a
a
k
a
a
a
a
"}
(18,1,1) = {"
a
k
a
a
k
a
a
a
a
a
a
a
a
a
a
k
a
a
k
a
"}
(19,1,1) = {"
a
k
I
I
H
a
a
k
H
H
H
H
k
a
a
H
I
I
k
a
"}
(20,1,1) = {"
a
k
a
a
H
a
a
a
a
a
a
a
a
a
a
H
a
a
k
a
"}
(21,1,1) = {"
a
a
a
a
k
k
k
k
a
a
a
a
k
k
k
k
a
a
a
a
"}
(22,1,1) = {"
a
a
a
a
a
k
a
a
a
a
a
a
T
a
k
a
a
a
a
a
"}
(23,1,1) = {"
a
a
a
a
a
H
a
a
a
a
a
a
a
a
H
a
a
a
a
a
"}
(24,1,1) = {"
a
a
a
a
a
H
a
a
a
a
a
a
a
a
H
a
a
a
a
a
"}
(25,1,1) = {"
a
a
a
a
a
H
H
H
u
H
H
u
H
H
H
a
a
a
a
a
"}
(26,1,1) = {"
a
a
a
a
a
a
a
a
a
a
a
a
a
a
a
a
a
a
a
a
"}
