//MAP CONVERTED BY dmm2tgm.py THIS HEADER COMMENT PREVENTS RECONVERSION, DO NOT REMOVE
"a" = (
/turf/open/space/basic,
/area/space)
"d" = (
/obj/structure/shuttle/engine/propulsion{
	dir = 8
	},
/turf/open/floor/plating,
/area/space)
"e" = (
/obj/machinery/computer/bsa_control,
/turf/open/floor/plating,
/area/space)
"f" = (
/obj/machinery/field/generator,
/turf/open/floor/plating,
/area/space)
"i" = (
/obj/structure/lattice/catwalk,
/turf/open/space/basic,
/area/space)
"j" = (
/obj/structure/window/plasma/reinforced/spawner/east,
/turf/open/space/basic,
/area/space)
"k" = (
/obj/structure/lattice,
/turf/open/space/basic,
/area/space)
"n" = (
/turf/closed/wall/r_wall/rust,
/area/space)
"o" = (
/obj/effect/spawner/structure/window/reinforced/shutters,
/turf/open/floor/plating,
/area/space)
"s" = (
/obj/structure/window/plasma/reinforced/spawner/east,
/obj/structure/window/plasma/reinforced/spawner/north,
/turf/open/space/basic,
/area/space)
"u" = (
/turf/open/floor/plating,
/area/space)
"v" = (
/obj/structure/window/plasma/reinforced/spawner/east,
/obj/structure/window/plasma/reinforced/spawner,
/turf/open/space/basic,
/area/space)
"w" = (
/turf/open/floor/plating{
	icon_state = "platingdmg3"
	},
/area/space)
"x" = (
/turf/closed/wall/rust,
/area/space)
"D" = (
/obj/structure/window/plasma/reinforced,
/turf/open/space/basic,
/area/space)
"I" = (
/turf/open/floor/plating{
	heat_capacity = 1e+006;
	icon_state = "platingdmg1"
	},
/area/space)
"L" = (
/obj/machinery/computer{
	desc = "A computer long since rendered non-functional due to lack of maintenance. Spitting out error messages.";
	dir = 1;
	name = "Broken Computer"
	},
/turf/open/space/basic,
/area/space)
"M" = (
/obj/structure/shuttle/engine/propulsion{
	dir = 8
	},
/turf/open/space/basic,
/area/space)
"R" = (
/obj/structure/window/plasma/reinforced/spawner,
/obj/structure/window/plasma/reinforced/spawner/west,
/turf/open/space/basic,
/area/space)
"T" = (
/obj/structure/window/plasma/reinforced,
/turf/open/floor/plating,
/area/space)
"U" = (
/obj/structure/window/plasma/reinforced/spawner/west,
/turf/open/space/basic,
/area/space)

(1,1,1) = {"
a
a
a
a
a
a
a
a
a
a
a
a
a
a
a
a
a
a
a
a
a
a
a
a
a
a
a
"}
(2,1,1) = {"
a
a
a
a
a
a
a
a
a
a
a
a
a
a
a
a
a
a
a
a
a
a
a
a
a
a
a
"}
(3,1,1) = {"
a
a
a
a
a
a
a
a
a
a
a
a
a
a
a
a
a
a
a
a
a
a
a
a
a
a
a
"}
(4,1,1) = {"
a
a
a
a
a
a
a
a
a
a
a
a
a
a
a
a
a
a
a
a
a
a
a
a
a
a
a
"}
(5,1,1) = {"
a
a
a
a
a
d
d
a
M
M
M
a
a
a
a
M
M
a
a
a
a
a
a
a
a
a
a
"}
(6,1,1) = {"
a
a
a
a
n
u
u
n
I
I
u
n
u
u
n
a
a
n
a
n
n
n
a
a
a
a
a
"}
(7,1,1) = {"
a
a
n
n
n
w
w
w
I
I
u
n
u
u
n
a
a
n
n
x
x
n
a
a
a
a
a
"}
(8,1,1) = {"
a
n
x
x
n
u
w
I
w
u
u
n
u
u
n
a
a
n
n
n
n
n
a
a
a
a
a
"}
(9,1,1) = {"
n
n
n
n
n
x
w
n
w
x
x
n
u
u
n
a
a
n
u
u
n
n
a
a
a
a
a
"}
(10,1,1) = {"
n
u
u
u
n
u
u
n
u
u
u
n
u
u
n
a
x
n
u
u
u
n
n
n
k
i
a
"}
(11,1,1) = {"
n
u
u
u
n
u
u
u
u
u
u
n
u
u
n
u
u
n
u
u
u
u
u
u
u
k
a
"}
(12,1,1) = {"
n
u
u
u
n
u
u
u
u
u
u
u
u
u
u
u
u
u
u
u
u
u
u
u
u
k
a
"}
(13,1,1) = {"
n
u
u
u
n
u
n
n
n
n
n
n
u
u
n
n
n
n
u
u
u
u
u
u
u
k
a
"}
(14,1,1) = {"
n
u
u
u
u
u
u
n
x
x
x
n
u
u
n
x
x
n
u
u
u
u
u
u
u
k
a
"}
(15,1,1) = {"
n
u
u
u
u
u
u
n
x
n
n
n
u
u
n
n
n
n
n
n
u
u
u
u
u
k
a
"}
(16,1,1) = {"
n
u
u
u
u
u
u
n
x
n
u
u
u
u
u
u
u
n
k
n
u
n
n
n
k
i
a
"}
(17,1,1) = {"
n
u
u
u
u
u
u
n
x
n
u
u
u
u
u
u
u
n
a
o
u
n
a
a
a
a
a
"}
(18,1,1) = {"
n
u
u
u
u
u
u
n
x
n
u
u
u
u
u
u
u
n
a
o
u
n
a
a
a
a
a
"}
(19,1,1) = {"
n
u
u
u
u
u
u
n
x
n
u
u
u
u
u
u
u
n
k
n
u
n
n
n
a
a
a
"}
(20,1,1) = {"
n
u
u
u
u
u
u
n
n
n
n
n
u
u
n
n
n
n
n
n
T
U
R
n
a
a
a
"}
(21,1,1) = {"
n
n
u
u
n
u
u
n
x
n
u
u
u
u
u
u
n
x
n
a
D
j
v
n
a
a
a
"}
(22,1,1) = {"
a
n
x
u
n
u
u
n
x
n
u
u
u
u
u
u
n
x
n
a
a
L
n
n
a
a
a
"}
(23,1,1) = {"
n
n
u
u
n
u
u
n
x
n
u
u
u
u
u
u
n
x
n
a
a
L
n
n
a
a
a
"}
(24,1,1) = {"
n
u
u
u
n
u
u
n
x
n
f
n
u
u
n
f
n
x
n
a
a
U
U
a
a
a
a
"}
(25,1,1) = {"
n
e
u
u
n
u
u
n
x
x
n
n
u
u
n
n
x
x
n
n
a
s
j
a
a
a
a
"}
(26,1,1) = {"
n
u
u
u
n
u
u
x
x
x
x
n
u
u
n
x
x
n
n
x
n
n
n
n
a
a
a
"}
(27,1,1) = {"
n
u
u
u
n
u
x
x
x
n
n
n
u
u
n
n
n
n
x
x
n
a
n
a
a
a
a
"}
(28,1,1) = {"
n
u
u
n
n
u
n
n
n
n
n
n
u
u
n
n
n
n
n
n
n
a
n
a
M
M
a
"}
(29,1,1) = {"
n
n
u
n
u
u
u
u
u
u
u
u
u
u
u
u
u
u
u
u
n
a
n
n
a
a
n
"}
(30,1,1) = {"
a
n
u
n
u
u
u
u
u
u
u
u
u
u
u
u
u
u
u
u
u
u
n
a
a
a
n
"}
(31,1,1) = {"
a
a
a
a
n
n
n
n
n
n
n
n
a
a
n
n
n
n
u
u
u
u
a
a
a
a
n
"}
(32,1,1) = {"
a
a
a
a
a
a
a
a
o
a
a
a
a
a
a
a
a
n
u
u
u
u
n
a
a
a
n
"}
(33,1,1) = {"
a
a
a
a
a
a
a
a
o
a
n
a
a
a
a
n
a
n
n
n
n
n
n
a
a
a
n
"}
(34,1,1) = {"
a
a
a
a
a
a
a
a
o
a
n
a
a
a
a
n
a
o
a
a
a
a
n
a
a
a
n
"}
(35,1,1) = {"
a
a
a
a
a
a
a
a
o
a
n
a
a
a
a
n
a
o
a
a
a
a
n
a
a
n
n
"}
(36,1,1) = {"
a
a
a
a
a
a
a
a
o
a
n
a
a
a
a
n
a
o
a
a
a
a
n
n
n
n
a
"}
(37,1,1) = {"
a
a
a
a
a
a
a
a
o
a
a
n
a
a
n
a
a
o
a
a
a
a
a
a
a
a
a
"}
(38,1,1) = {"
a
a
a
a
a
a
a
a
o
o
a
a
n
n
a
a
o
o
a
a
a
a
a
a
a
a
a
"}
(39,1,1) = {"
a
a
a
a
a
a
a
a
a
o
o
a
a
a
a
o
o
a
a
a
a
a
a
a
a
a
a
"}
(40,1,1) = {"
a
a
a
a
a
a
a
a
a
a
o
a
a
a
a
o
a
a
a
a
a
a
a
a
a
a
a
"}
(41,1,1) = {"
a
a
a
a
a
a
a
a
a
a
o
o
o
o
o
o
a
a
a
a
a
a
a
a
a
a
a
"}
(42,1,1) = {"
a
a
a
a
a
a
a
a
a
a
a
a
a
a
a
a
a
a
a
a
a
a
a
a
a
a
a
"}
