//MAP CONVERTED BY dmm2tgm.py THIS HEADER COMMENT PREVENTS RECONVERSION, DO NOT REMOVE
"a" = (
/turf/open/space/basic,
/area/space)
"b" = (
/obj/structure/shuttle/engine/propulsion{
	dir = 8
	},
/turf/open/floor/plating,
/area/space)
"c" = (
/obj/machinery/door/airlock/hatch,
/obj/effect/mapping_helpers/airlock/locked,
/turf/closed/wall/r_wall/rust,
/area/space)
"d" = (
/obj/structure/window/plasma/reinforced,
/turf/open/floor/plating,
/area/space)
"e" = (
/turf/open/floor/plating{
	icon_state = "platingdmg3"
	},
/area/space)
"f" = (
/obj/structure/window/plasma/reinforced/spawner/east,
/obj/structure/window/plasma/reinforced/spawner,
/turf/open/space/basic,
/area/space)
"g" = (
/obj/structure/window/plasma/reinforced/spawner,
/obj/structure/window/plasma/reinforced/spawner/west,
/turf/open/space/basic,
/area/space)
"h" = (
/obj/structure/window/reinforced/spawner/west,
/obj/structure/window/reinforced/spawner/north,
/turf/open/floor/plasteel/patterned/ridged,
/area/space)
"i" = (
/turf/open/floor/plasteel/patterned/ridged,
/area/space)
"k" = (
/obj/machinery/door/airlock/engineering,
/turf/open/space/basic,
/area/space)
"l" = (
/obj/structure/window/reinforced/spawner,
/obj/structure/window/reinforced/spawner/east,
/turf/open/floor/plasteel/patterned/ridged,
/area/space)
"m" = (
/obj/machinery/door/airlock/highsecurity,
/turf/open/space/basic,
/area/space)
"n" = (
/obj/structure/window/reinforced/spawner/east,
/obj/structure/window/reinforced/spawner,
/turf/open/floor/plasteel/patterned/ridged,
/area/space)
"o" = (
/turf/closed/wall/r_wall/rust,
/area/space)
"s" = (
/obj/machinery/door/airlock/hatch,
/obj/effect/mapping_helpers/airlock/locked,
/turf/open/floor/plating,
/area/space)
"u" = (
/obj/structure/window/plasma/reinforced/spawner/west,
/turf/open/floor/plating{
	icon_state = "platingdmg3"
	},
/area/space)
"v" = (
/obj/machinery/door/airlock/engineering,
/turf/open/floor/plating{
	icon_state = "platingdmg3"
	},
/area/space)
"x" = (
/obj/machinery/computer{
	desc = "A computer long since rendered non-functional due to lack of maintenance. Spitting out error messages.";
	dir = 1;
	name = "Broken Computer"
	},
/turf/open/floor/plating,
/area/space)
"y" = (
/obj/structure/window/reinforced/spawner/west,
/turf/open/floor/plasteel/tech/grid,
/area/space)
"z" = (
/obj/structure/lattice,
/turf/open/space/basic,
/area/space)
"A" = (
/obj/structure/window/reinforced/spawner,
/obj/structure/window/reinforced/spawner/west,
/turf/open/floor/plasteel/patterned/ridged,
/area/space)
"B" = (
/obj/machinery/computer/bsa_control,
/turf/open/floor/plating,
/area/space)
"C" = (
/obj/structure/window/reinforced/spawner/east,
/turf/open/floor/plasteel/patterned/ridged,
/area/space)
"D" = (
/obj/structure/shuttle/engine/propulsion{
	dir = 8
	},
/turf/open/space/basic,
/area/space)
"E" = (
/obj/structure/window/plasma/reinforced/spawner/west,
/turf/open/space/basic,
/area/space)
"G" = (
/turf/open/floor/plating,
/area/space)
"H" = (
/turf/open/floor/plasteel/tech/grid,
/area/space)
"I" = (
/obj/machinery/door/airlock/highsecurity,
/turf/open/floor/plating,
/area/space)
"J" = (
/turf/closed/wall/rust,
/area/space)
"K" = (
/obj/machinery/door/airlock/mining,
/turf/open/floor/plating,
/area/space)
"N" = (
/obj/structure/lattice/catwalk,
/turf/open/space/basic,
/area/space)
"O" = (
/obj/structure/window/reinforced/spawner/east,
/obj/structure/window/reinforced/spawner/north,
/turf/open/floor/plasteel/patterned/ridged,
/area/space)
"P" = (
/obj/structure/window/plasma/reinforced/spawner/east,
/turf/open/floor/plating{
	heat_capacity = 1e+006;
	icon_state = "platingdmg1"
	},
/area/space)
"Q" = (
/obj/machinery/field/generator,
/turf/open/floor/plating,
/area/space)
"R" = (
/obj/structure/window/plasma/reinforced/spawner/east,
/turf/open/space/basic,
/area/space)
"S" = (
/obj/effect/spawner/structure/window/reinforced/shutters,
/turf/open/floor/plating,
/area/space)
"T" = (
/obj/machinery/door/airlock/hatch,
/turf/open/floor/plating,
/area/space)
"U" = (
/obj/structure/window/plasma/reinforced/spawner/east,
/obj/structure/window/plasma/reinforced/spawner/north,
/turf/open/floor/plating,
/area/space)
"X" = (
/obj/structure/window/reinforced/spawner/north,
/obj/structure/window/reinforced/spawner/east,
/turf/open/floor/plasteel/patterned/ridged,
/area/space)
"Y" = (
/turf/open/floor/plating{
	heat_capacity = 1e+006;
	icon_state = "platingdmg1"
	},
/area/space)

(1,1,1) = {"
a
a
a
a
a
a
a
a
a
a
a
a
a
a
a
a
a
a
a
a
a
a
a
a
a
a
a
"}
(2,1,1) = {"
a
a
a
a
a
a
a
a
a
a
a
a
a
a
a
a
a
a
a
a
a
a
a
a
a
a
a
"}
(3,1,1) = {"
a
a
a
a
a
a
a
a
a
a
a
a
a
a
a
a
a
a
a
a
a
a
a
a
a
a
a
"}
(4,1,1) = {"
a
a
a
a
a
a
a
a
a
a
a
a
a
a
a
a
a
a
a
a
a
a
a
a
a
a
a
"}
(5,1,1) = {"
a
a
a
a
a
b
b
a
D
D
D
a
a
a
a
D
D
a
a
a
a
a
a
a
a
a
a
"}
(6,1,1) = {"
a
a
a
a
o
G
G
o
Y
Y
G
o
G
G
o
a
a
o
a
o
o
o
a
a
a
a
a
"}
(7,1,1) = {"
a
a
o
o
o
e
e
e
Y
Y
G
o
G
G
o
a
a
o
o
J
J
o
a
a
a
a
a
"}
(8,1,1) = {"
a
o
J
J
o
G
e
Y
e
G
G
o
G
G
o
a
a
o
o
o
o
o
a
a
a
a
a
"}
(9,1,1) = {"
o
o
o
o
o
J
v
o
v
J
J
o
G
G
o
a
a
o
G
G
o
o
a
a
a
a
a
"}
(10,1,1) = {"
o
G
G
G
o
G
G
o
G
G
G
o
G
G
o
k
J
o
G
G
G
o
o
o
z
N
a
"}
(11,1,1) = {"
o
G
G
G
o
G
G
G
G
G
G
o
G
G
o
G
G
o
G
G
G
G
G
G
G
z
a
"}
(12,1,1) = {"
o
G
G
G
o
G
G
G
G
G
G
T
G
G
T
G
G
K
G
G
G
G
G
G
G
z
a
"}
(13,1,1) = {"
o
G
G
G
o
T
o
o
o
o
o
o
G
G
o
o
o
o
G
G
G
G
G
G
G
z
a
"}
(14,1,1) = {"
o
G
G
G
G
G
G
o
J
J
J
o
G
G
o
J
J
o
G
G
G
G
G
G
G
z
a
"}
(15,1,1) = {"
o
G
G
G
G
G
G
o
J
o
o
o
T
T
o
o
o
o
o
o
K
o
G
G
G
z
a
"}
(16,1,1) = {"
o
G
G
G
G
G
G
o
J
o
G
G
G
G
G
G
G
o
z
o
G
o
o
o
z
N
a
"}
(17,1,1) = {"
o
G
G
G
G
G
G
o
J
o
G
G
G
G
G
G
G
o
a
S
G
o
a
a
a
a
a
"}
(18,1,1) = {"
o
G
G
G
G
G
G
o
J
o
G
G
G
G
G
G
G
o
a
S
G
o
a
a
a
a
a
"}
(19,1,1) = {"
o
G
G
G
G
G
G
o
J
o
G
G
G
G
G
G
G
o
z
o
s
o
o
o
a
a
a
"}
(20,1,1) = {"
o
G
G
G
G
G
G
o
o
o
o
o
I
I
o
o
o
o
o
o
d
E
g
o
a
a
a
"}
(21,1,1) = {"
o
o
G
G
o
G
G
o
J
o
G
G
G
G
G
G
o
o
J
o
d
R
f
o
a
a
a
"}
(22,1,1) = {"
a
o
J
G
o
G
G
o
J
o
G
G
G
G
G
G
o
o
J
o
G
x
o
o
a
a
a
"}
(23,1,1) = {"
o
o
G
G
o
G
G
o
J
o
G
G
G
G
G
G
o
o
J
o
e
x
o
o
a
a
a
"}
(24,1,1) = {"
o
G
G
G
o
G
G
o
J
G
Q
o
I
I
o
Q
G
J
J
o
e
u
u
Y
a
a
a
"}
(25,1,1) = {"
o
B
G
G
o
G
G
o
J
o
o
o
G
G
o
o
o
o
J
o
G
U
P
z
a
a
a
"}
(26,1,1) = {"
o
G
G
G
o
G
o
o
J
J
J
G
G
G
G
o
J
J
J
o
c
o
o
o
a
a
a
"}
(27,1,1) = {"
o
G
G
G
o
G
o
J
J
o
o
G
G
G
G
o
o
J
J
o
a
o
o
a
a
a
a
"}
(28,1,1) = {"
o
G
G
o
o
G
o
o
o
o
o
G
G
G
G
o
o
o
o
o
a
o
o
a
D
D
a
"}
(29,1,1) = {"
o
o
G
o
G
G
G
G
G
G
G
G
G
G
G
G
G
G
G
o
a
o
o
o
a
a
o
"}
(30,1,1) = {"
a
o
G
o
G
G
G
G
G
G
G
G
G
G
G
G
G
G
G
G
G
G
o
a
a
a
o
"}
(31,1,1) = {"
a
a
a
o
o
o
o
o
o
o
o
o
m
o
o
o
o
o
G
G
G
G
k
a
a
a
o
"}
(32,1,1) = {"
a
a
a
o
a
a
o
a
S
H
i
i
i
i
i
H
o
G
a
G
G
G
o
a
a
a
o
"}
(33,1,1) = {"
a
a
a
S
a
a
S
a
S
H
h
i
i
i
A
H
o
o
a
o
o
o
o
a
a
a
o
"}
(34,1,1) = {"
a
a
a
S
a
a
S
a
S
H
X
i
i
i
l
H
S
a
a
a
a
a
o
a
a
a
o
"}
(35,1,1) = {"
a
a
a
N
o
o
N
a
S
H
h
i
i
i
A
H
S
a
a
a
a
a
o
a
a
o
o
"}
(36,1,1) = {"
a
a
a
a
a
a
a
a
S
H
O
i
i
i
l
H
S
a
a
a
a
a
o
o
o
o
a
"}
(37,1,1) = {"
a
a
a
a
a
a
a
a
S
H
i
O
C
n
i
H
S
a
a
a
a
a
a
a
a
a
a
"}
(38,1,1) = {"
a
a
a
a
a
a
a
a
S
S
H
i
C
i
H
S
S
a
a
a
a
a
a
a
a
a
a
"}
(39,1,1) = {"
a
a
a
a
a
a
a
a
a
S
S
H
y
H
S
S
a
a
a
a
a
a
a
a
a
a
a
"}
(40,1,1) = {"
a
a
a
a
a
a
a
a
a
a
S
S
S
S
S
a
a
a
a
a
a
a
a
a
a
a
a
"}
(41,1,1) = {"
a
a
a
a
a
a
a
a
a
a
a
a
a
a
a
a
a
a
a
a
a
a
a
a
a
a
a
"}
(42,1,1) = {"
a
a
a
a
a
a
a
a
a
a
a
a
a
a
a
a
a
a
a
a
a
a
a
a
a
a
a
"}
